Bộ xử lý
Hãng CPU :	Intel
Công nghệ CPU :	Core i3
Loại CPU :	7020U
Số lõi :	2
Số luồng :	4
Tốc độ CPU :	2.30 GHz
Tốc độ tối đa :	Không
Bộ nhớ đệm :	3 MB Smart Cache
Tốc độ BUS :	4 GT/s
RAM
Dung lượng RAM :	4 GB
Loại RAM :	DDR4
Tốc độ RAM :	2133 MHz
Số khe cắm rời :	2
Số khe RAM còn lại :	1
Số RAM onboard :	Đang cập nhật
Hỗ trợ RAM tối đa :	8 GB
Màn hình
Kích thước màn hình :	15.6"
Loại màn hình :	LED
Độ phân giải :	1366 x 768 Pixel
Tần số quét :	60 Hz
Độ sáng :	220 nits
Tấm nền :	SVA
Công nghệ màn hình :	BrightView WLED-backlit
Độ phủ màu :	45% NTSC
Tỷ lệ màn hình :	16:09
Độ tương phản :	Đang cập nhật
Màn hình cảm ứng :	Không
Loại cảm ứng :	Không
Đồ họa
Hãng (Card onboard) :	Intel
Card onboard :	HD Graphics
Model (Card onboard) :	620
Xung nhịp (Card onboard) :	300 MHz
Xung nhịp tối đa (Card onboard) :	1000 MHz
Hãng (Card rời) :	NVIDIA
Card rời :	GeForce Series
Model (Card rời) :	MX110
Bộ nhớ đồ họa (Card rời) :	2 GB
Kiểu bộ nhớ :	DDR3
Xung nhịp (Card rời) :	Đang cập nhật
Xung nhịp tối đa (Card rời) :	Đang cập nhật
Lưu trữ
Loại HDD :	SATA 3
Dung Lượng HDD :	500 GB
Tốc độ quay HDD :	5400 rpm
Hỗ trợ công nghệ Optane :	Đang cập nhật
Tổng số khe cắm SSD/HDD :	2
Số khe SSD/HDD còn lại :	1
Chuẩn M2 :	2280
Giao tiếp & Kết nối
Số cổng Type-C :	0
Số cổng USB 3.0 :	2
Số cổng USB 2.0 :	1
Số cổng HDMI :	1
Số cổng VGA :	0
Số cổng Card reader :	1
Số cổng DC-in jack :	1
Số cổng 3.5 mm :	1
Số cổng Thunderbolt :	0
Số cổng LAN :	1
Wireless :	802.11 b/g/n
Bluetooth :	v4.2
Khe đọc thẻ nhớ :	1 multi-format SD media card reader
Senser :	Không
Webcame :	HD Web Camera
Âm thanh
Số Loa :	2
Công nghệ âm thanh :	HP audio boost
Bảo mật
Mở khóa vân tay (Finger Print) :	Không
Nhận diện khuôn mặt :	Không
Mật khẩu :	Có
Ổ đĩa quang
Loại ổ đĩa quang :	Không
Ổ đĩa quang :	Không
Bàn phím & TouchPad
Kiểu bàn phím :	Full-size
Bàn phím số :	Có
Loại đèn bàn phím :	Không
Công nghệ đèn bàn phím :	Đang cập nhật
Màu đèn LED :	Đang cập nhật
TouchPad :	Đang cập nhật
Thông tin pin
Loại PIN :	Lithium-ion
PIN (Cell) :	3 Cell
PIN có thể tháo rời :	Không
Power Supply :	65 W
Hệ điều hành
OS :	Windows 10
Type :	64 bit
Version :	Home Single Language
Thiết kế & Trọng lượng
Width (mm) :	376
Depth (mm) :	246
Height (mm) :	22.5
Trọng lượng (kg) :	1.77
Chất liệu mặt bên ngoài cùng :	Nhựa
Chất liệu khung màn hình :	Nhựa
Chất liệu mặt bàn phím + kê tay :	Nhựa
Chất liệu mặt lưng :	Nhựa
Thông tin thêm
Bản lề (Hinge / Kickstand) :	bản lề đôi
Tản nhiệt :	1 quạt
Thông tin hàng hóa
P/N :	4ME82PA
Năm ra mắt :	Đang cập nhật
Xuất xứ :	Trung Quốc
Thời gian bảo hành :	12 Tháng
Phụ kiện trong hộp
Phụ kiện kèm theo :	Sạc, sách hướng dẫn,