Bộ xử lý
Hãng CPU :	Intel
Công nghệ CPU :	Core i3
Loại CPU :	10110U
Số lõi :	2
Số luồng :	4
Tốc độ CPU :	2.10 GHz
Tốc độ tối đa :	4.10 GHz
Bộ nhớ đệm :	4 MB Smart Cache
Tốc độ BUS :	4 GT/s
RAM
Dung lượng RAM :	4 GB
Loại RAM :	DDR4
Tốc độ RAM :	2666 MHz
Số khe cắm rời :	2
Số khe RAM còn lại :	1
Số RAM onboard :	0
Hỗ trợ RAM tối đa :	16 GB
Màn hình
Kích thước màn hình :	15.6"
Loại màn hình :	LED
Độ phân giải :	1920 x 1080 Pixel
Tần số quét :	60 Hz
Độ sáng :	220 nits
Tấm nền :	TN
Công nghệ màn hình :	Anti-glare LED-backlit
Độ phủ màu :	45% NTSC
Tỷ lệ màn hình :	16:09
Độ tương phản :	Đang cập nhật
Màn hình cảm ứng :	Không
Loại cảm ứng :	Không
Đồ họa
Hãng (Card onboard) :	Intel
Card onboard :	UHD Graphics
Model (Card onboard) :	620
Xung nhịp (Card onboard) :	300 MHz
Xung nhịp tối đa (Card onboard) :	1100 MHz
Lưu trữ
Kiểu SSD :	M2. PCIe
Dung lượng SSD :	256 GB
Tốc độ đọc/ghi :	Đang cập nhật
Hỗ trợ công nghệ Optane :	Có
Tổng số khe cắm SSD/HDD :	2
Số khe SSD/HDD còn lại :	1
Chuẩn M2 :	2280
Giao tiếp & Kết nối
Số cổng Type-C :	0
Số cổng USB 3.0 :	2
Số cổng USB 2.0 :	1
Số cổng HDMI :	1
Số cổng VGA :	1
Số cổng Card reader :	1
Số cổng DC-in jack :	1
Số cổng 3.5 mm :	1
Số cổng Thunderbolt :	0
Số cổng LAN :	1
Wireless :	802.11 a/b/g/n/ac
Bluetooth :	v5.0
Khe đọc thẻ nhớ :	SD card
Senser :	FingerPrint
Webcame :	HD Web Camera
Âm thanh
Số Loa :	2
Công nghệ âm thanh :	Realtek High Definition Audio
Bảo mật
Mở khóa vân tay (Finger Print) :	Có
Nhận diện khuôn mặt :	Không
Mật khẩu :	Không
Ổ đĩa quang
Loại ổ đĩa quang :	Không
Ổ đĩa quang :	Không
Bàn phím & TouchPad
Kiểu bàn phím :	English International Non-backlit Keyboard
Bàn phím số :	Có
Loại đèn bàn phím :	Không
Công nghệ đèn bàn phím :	Không
Màu đèn LED :	Không
TouchPad :	TouchPad với nút bật / tắt và hỗ trợ cử chỉ đa cảm ứng
Thông tin pin
Loại PIN :	Lithium-ion
PIN (Cell) :	3 Cell
PIN có thể tháo rời :	Không
Power Supply :	Đang cập nhật
Hệ điều hành
OS :	Windows 10
Type :	64 bit
Version :	Home Single Language
Thiết kế & Trọng lượng
Width (mm) :	380
Depth (mm) :	258
Height (mm) :	20
Trọng lượng (kg) :	1.99
Chất liệu mặt bên ngoài cùng :	Nhựa
Chất liệu khung màn hình :	Nhựa
Chất liệu mặt bàn phím + kê tay :	Nhựa
Chất liệu mặt lưng :	Nhựa
Thông tin thêm
Bản lề (Hinge / Kickstand) :	Mở rộng 130 độ
Tản nhiệt :	1 quạt
Thông tin hàng hóa
P/N :	V5I3101W
Năm ra mắt :	2020
Xuất xứ :	Trung Quốc
Thời gian bảo hành :	12 Tháng
Phụ kiện trong hộp
Phụ kiện kèm theo :	01 Adapter 45 Watt, Sách HDSD