Bộ xử lý
Hãng CPU :	AMD
Công nghệ CPU :	Ryzen 5
Loại CPU :	3500U
Số lõi :	4
Số luồng :	8
Tốc độ CPU :	2.10 GHz
Tốc độ tối đa :	3.70 GHz
Bộ nhớ đệm :	4 MB L3 Cache
Tốc độ BUS :	Đang cập nhật
RAM
Dung lượng RAM :	4 GB
Loại RAM :	DDR4
Tốc độ RAM :	2400 MHz
Số khe cắm rời :	1
Số khe RAM còn lại :	1
Số RAM onboard :	1
Hỗ trợ RAM tối đa :	12 GB
Màn hình
Kích thước màn hình :	14.0"
Loại màn hình :	LED
Độ phân giải :	1920 x 1080 Pixel
Tần số quét :	60 Hz
Độ sáng :	200 nits
Tấm nền :	Đang cập nhật
Công nghệ màn hình :	LED-backlit
Độ phủ màu :	45% NTSC
Tỷ lệ màn hình :	16:09
Độ tương phản :	Đang cập nhật
Màn hình cảm ứng :	Không
Loại cảm ứng :	Không
Đồ họa
Hãng (Card onboard) :	AMD
Card onboard :	Radeon Graphics
Model (Card onboard) :	Vega 8
Xung nhịp (Card onboard) :	300 MHz
Xung nhịp tối đa (Card onboard) :	1100 MHz
Lưu trữ
Kiểu SSD :	M2. PCIe
Dung lượng SSD :	512 GB
Tốc độ đọc/ghi :	Đang cập nhật
Hỗ trợ công nghệ Optane :	Đang cập nhật
Tổng số khe cắm SSD/HDD :	1
Số khe SSD/HDD còn lại :	0
Chuẩn M2 :	Đang cập nhật
Giao tiếp & Kết nối
Số cổng Type-C :	1
Số cổng USB 3.0 :	Đang cập nhật
Số cổng USB 2.0 :	2
Số cổng HDMI :	1
Số cổng VGA :	Đang cập nhật
Số cổng Card reader :	1
Số cổng DC-in jack :	Đang cập nhật
Số cổng 3.5 mm :	Đang cập nhật
Số cổng Thunderbolt :	Đang cập nhật
Số cổng LAN :	Đang cập nhật
Wireless :	802.11 ac
Bluetooth :	v4.2
Khe đọc thẻ nhớ :	NA
Senser :	Không
Webcame :	HD Web Camera
Âm thanh
Số Loa :	Đang cập nhật
Công nghệ âm thanh :	Đang cập nhật
Bảo mật
Mở khóa vân tay (Finger Print) :	Có
Nhận diện khuôn mặt :	Không
Mật khẩu :	Không
Ổ đĩa quang
Loại ổ đĩa quang :	Không
Ổ đĩa quang :	Không
Bàn phím & TouchPad
Kiểu bàn phím :	Chiclet Keyboard
Bàn phím số :	Không
Loại đèn bàn phím :	Đang cập nhật
Công nghệ đèn bàn phím :	Không
Màu đèn LED :	Đang cập nhật
TouchPad :	Đang cập nhật
Thông tin pin
Loại PIN :	Lithium-Polymer
PIN (Cell) :	2 Cell
PIN có thể tháo rời :	Không
Power Supply :	Đang cập nhật
Hệ điều hành
OS :	Windows 10
Type :	64 bit
Version :	Home Single Language
Thiết kế & Trọng lượng
Width (mm) :	360
Depth (mm) :	216
Height (mm) :	23.1
Trọng lượng (kg) :	1.9
Chất liệu mặt bên ngoài cùng :	Nhựa
Chất liệu khung màn hình :	Nhựa
Chất liệu mặt bàn phím + kê tay :	Nhựa
Chất liệu mặt lưng :	Nhựa
Thông tin thêm
Bản lề (Hinge / Kickstand) :	Ergolift
Tản nhiệt :	Đang cập nhật
Thông tin hàng hóa
P/N :	D409DA-EK109T
Năm ra mắt :	2020
Xuất xứ :	Trung Quốc
Thời gian bảo hành :	24 Tháng
Phụ kiện trong hộp
Phụ kiện kèm theo :	Sạc, HDSD